NO assets/textures/north.xpm
SO assets/textures/south.xpm
WE assets/textures/west.xpm
EA assets/textures/east.xpm
F  40,40,40
C  120,160,220

1111111111
1000000001
1011111101
1010N00001
1010110101
1010000101
1011111101
1000000001
1111111111
